C,C,C,M,C,C,C
C,M,C,C,C,M,C
C,C,M,M,C,M,C
C,M,C,C,C,M,C
C,C,M,C,C,C,C