C,C,C,C,C,R,C
C,M,C,M,C,M,C
R,C,C,C,C,R,C
C,M,C,M,C,M,C
C,C,C,R,C,C,C
C,M,R,M,C,M,C
C,C,C,C,R,R,C